30.ox
o.o....ooo.
.o...o..oo.
o....o.....
.oo........
oo...o.oo..
...o..o....
.oo..oo...o
......o..oo
.....o.....
.o.......o.
o...o......
...........
.o.o..o....
o.oo.o...o.
...o..o.o.o
.o..o...o..
...o..o.o..
oo....o..o.
....oo...o.
....o..oo..
o.....o..o.
.o......o..
..o..o.o...
..o.o...o..
...........
.o.o.o.o...
..........o
.ooo...o.oo
...o...oo..
........o..
